mapVersion=4
{
  "width" : 41,
  "height" : 41,
  "name" : "Castle",
  "basePositions" : {
    "1" : {
      "x" : 2,
      "y" : 20
    },
    "2" : {
      "x" : 38,
      "y" : 20
    }
  },
  "maxResources" : 12,
  "resourceFields" : [ {
    "x" : 24,
    "y" : 23
  }, {
    "x" : 18,
    "y" : 17
  }, {
    "x" : 22,
    "y" : 23
  }, {
    "x" : 16,
    "y" : 17
  }, {
    "x" : 20,
    "y" : 23
  }, {
    "x" : 14,
    "y" : 17
  }, {
    "x" : 18,
    "y" : 23
  }, {
    "x" : 16,
    "y" : 23
  }, {
    "x" : 21,
    "y" : 29
  }, {
    "x" : 20,
    "y" : 29
  }, {
    "x" : 14,
    "y" : 23
  }, {
    "x" : 19,
    "y" : 29
  }, {
    "x" : 21,
    "y" : 11
  }, {
    "x" : 20,
    "y" : 11
  }, {
    "x" : 26,
    "y" : 17
  }, {
    "x" : 19,
    "y" : 11
  }, {
    "x" : 24,
    "y" : 17
  }, {
    "x" : 22,
    "y" : 17
  }, {
    "x" : 26,
    "y" : 23
  }, {
    "x" : 20,
    "y" : 17
  } ],
  "descriptors" : [ ]
}
OOOOOOOOOOOOOOOOOOOOOOOOOOOOOOOOOOOOOOOOO
OO     O   ~~~~~~~~~~~~~~~~~~~   O     OO
O O   O  ~~~~~~~         ~~~~~~~  O   O O
O  O O ~~~~~~               ~~~~~~ O O  O
O   O~~~~~~                   ~~~~~~O   O
O  O~~~~~                       ~~~~~O  O
O O ~~~~                         ~~~~ O O
OO ~~~~    OOO~~~O~~~~~O~~~OOO    ~~~~ OO
O  ~~~     O                 O     ~~~  O
O ~~~    OOO                 OOO    ~~~ O
O ~~~    O    OOOOOO OOOOOO    O    ~~~ O
O~~~   OOO   OO   O   O   OO   OOO   ~~~O
O~~~   O     O    OOOOO    O     O   ~~~O
O~~   ~O     O             O     O~   ~~O
O~~   ~O  O     O       O     O  O~   ~~O
O~~   ~O                         O~   ~~O
O~    ~O                         O~    ~O
O    ~~OOO   O O O O O O O O   OOO~~    O
O        O   OOOOOOOOOOOOOOO   O        O
O      O                         O      O
O B                                   B O
O      O                         O      O
O        O   OOOOOOOOOOOOOOO   O        O
O    ~~OOO   O O O O O O O O   OOO~~    O
O~    ~O                         O~    ~O
O~~   ~O                         O~   ~~O
O~~   ~O  O     O       O     O  O~   ~~O
O~~   ~O     O             O     O~   ~~O
O~~~   O     O    OOOOO    O     O   ~~~O
O~~~   OOO   OO   O   O   OO   OOO   ~~~O
O ~~~    O    OOOOOO OOOOOO    O    ~~~ O
O ~~~    OOO                 OOO    ~~~ O
O  ~~~     O                 O     ~~~  O
OO ~~~~    OOO~~~O~~~~~O~~~OOO    ~~~~ OO
O O ~~~~                         ~~~~ O O
O  O~~~~~                       ~~~~~O  O
O   O~~~~~~                   ~~~~~~O   O
O  O O ~~~~~~               ~~~~~~ O O  O
O O   O  ~~~~~~~         ~~~~~~~  O   O O
OO     O   ~~~~~~~~~~~~~~~~~~~   O     OO
OOOOOOOOOOOOOOOOOOOOOOOOOOOOOOOOOOOOOOOOO
